a----w-----
-----w----1
----------1
-----w----2
-----w----2
w-wwww-----
-----www-ww
--a--w-----
---a-w-----
---------a-
-----w-----
