a----w-----
-----w----1
----------1
-----w----2
---a-w3---2
w-wwww3----
-----www-ww
--a--w-----
---a-w-----
---------a-
-----w-a---
