wwwwwwwwwwwwwwwwwww
w---------w-aa----w
w-wwwwwwwww-wwwww-w
w-----------w---w-w
w-wwwwwwwwwww-w-w-w
w-w-----w---w-w---w
w-w-www-w-w-w-www-w
w-w-w---w-w---w---w
w-w-w-www-wwwww-www
w---w---w-w---w---w
w-wwwww-w-w-w-w-w-w
w-w-----w---w-w-w-w
w-w-wwwwwwwww-w-www
w-w-w-----w---w---w
w-www-www-w-wwwwwww
w-w---w-w-w-------w
w-w-w-w-w-wwwwwww-w
w---w---w---ggw---w
wwwwwwwwwwwwwwwwwww
