wwwwwwwwwwwwwwwwwwwww
wg---w----w----w----w
wg--------w---------w
w----w---------w----w
w----w----w----w----w
wwwwwwwwwwwwwwwwww-ww
w----w----w----w----w
w---------w---------w
w----w---------w----w
w----w----w----w----w
www-wwwwwwwww-www-www
w----w----w----w----w
w----w----w----w----w
w----w---------w----w
w----w----w----w----w
ww-wwwwwwwwwwwwwww-ww
w----w----w----w----w
w----w---------w----w
w---------w---------w
w----w----w--aaw----w
wwwwwwwwwwwwwwwwwwwww
