a----w-----
-----w--ggg
--------ggg
-----w--ggg
-----w--ggg
w-wwww-----
-----www-ww
-----w-----
-----w-----
---------a-
-----w-----
