a----w-----
-----w----g
----------g
-----w----g
-----w----g
w-wwww-----
-----www-ww
--a--w-----
---a-w-----
---------a-
-----w-----
