a----w222--
-----w----1
----------1
-----w3---1
---a-w3----
w-wwww3----
-----www-ww
--a--w-----
---a-w-----
---------a-
-----w-a---
