wwwwwwwwwwwwwwwwwwwww
w----w----w----w---gw
w---------w--------gw
w----w---------w---gw
w----w----w----w---gw
wwwwwwwwwwwwwwwwww-ww
w----w----w----w----w
w---------w---------w
w----w---------w----w
w----w----w----w----w
www-wwwwwwwww-www-www
w----w----w----w----w
w----w----w----w----w
w----w---------w----w
w----w----w----w----w
ww-wwwwwwwwwwwwwww-ww
w----w----w----w----w
w----w---------w----w
w---------w---------w
waa--w----w-aa-w----w
wwwwwwwwwwwwwwwwwwwww
