wwwwwwwwwwwwwwwwwwwww
w----w----w1---w---2w
w---------w1-------2w
w----w---------w----w
w----w----w----w----w
wwwwwwwwwwwwwwwwww-ww
w----w----w----w----w
w---------w---------w
w----w---------w----w
w----w----w----w----w
www-wwwwwwwww-www-www
w----w----w----w----w
w----w----w----w----w
w----w---------w----w
w----w-aa-w----w----w
ww-wwwwwwwwwwwwwww-ww
w----w----w----w----w
w----w---------w----w
w---------w---------w
waa--w----w----w----w
wwwwwwwwwwwwwwwwwwwww
