a----w-----
-----w-----
-----------
-----w----g
-----w-----
w-wwww-----
-----www-ww
-----w-----
-----w-----
---------a-
-----w-----
