a----w----g
-----w----g
-----w----g
-----w----g
-----w----g
-----w----g
----------g
-----w----g
-----w----g
-a---w----g
-----w----g
